F1,League,Year,position,Team,matches,wins,draws,loses,scored,missed,pts,HYellow,AYellow,HRed,ARed,HCorners,ACorners,HFouls,AFouls,H_RS_OnTarget,A_RS_OnTarget,H_Rival_Fouls,A_Rival_Fouls,Corners,Shots,Yellow,Red,Fouls,S_OnTarget
0,La_liga,2014,1,Barcelona,38,30,4,4,110,21,94,31,35,2,1,128,105,197,172,42,49,259,323,233,626,66,3,369,273
1,La_liga,2014,2,Real Madrid,38,30,2,6,118,38,92,37,48,1,2,141,105,201,206,60,76,290,290,246,688,85,3,407,282
2,La_liga,2014,3,Atletico Madrid,38,23,9,6,67,29,78,45,64,2,3,120,75,270,273,41,55,297,269,195,438,109,5,543,187
3,La_liga,2014,4,Valencia,38,22,11,5,70,32,77,45,56,1,8,94,74,274,292,48,77,288,349,168,439,101,9,566,159
4,La_liga,2014,5,Sevilla,38,23,7,8,71,45,76,56,59,1,1,114,85,299,305,56,92,247,280,199,455,115,2,604,181
5,La_liga,2014,6,Villarreal,38,16,12,10,48,37,60,29,65,1,1,134,95,228,298,65,81,241,240,229,508,94,2,526,178
6,La_liga,2014,7,Athletic Club,38,15,10,13,42,41,55,48,48,1,3,122,87,269,260,58,84,275,262,209,441,96,4,529,147
7,La_liga,2014,8,Celta Vigo,38,13,12,13,47,44,51,48,67,3,2,141,99,267,319,58,90,268,252,240,496,115,5,586,166
8,La_liga,2014,9,Malaga,38,14,8,16,42,48,50,55,46,4,4,121,80,262,296,75,75,273,268,201,457,101,8,558,165
9,La_liga,2014,10,Rayo Vallecano,38,15,4,19,46,68,49,54,52,4,2,111,87,276,278,79,103,278,295,198,493,106,6,554,172
10,La_liga,2014,11,Espanyol,38,13,10,15,47,51,49,56,60,2,4,106,71,331,283,74,93,309,262,177,381,116,6,614,140
11,La_liga,2014,12,Real Sociedad,38,11,13,14,44,51,46,40,48,0,1,116,86,269,243,79,92,311,270,202,427,88,1,512,132
12,La_liga,2014,13,Elche,38,11,8,19,35,62,41,54,48,3,3,93,74,293,291,86,92,256,251,167,408,102,6,584,129
13,La_liga,2014,14,Getafe,38,10,7,21,33,64,37,48,45,1,3,103,79,274,267,74,99,248,257,182,420,93,4,541,144
14,La_liga,2014,15,Levante,38,9,10,19,34,67,37,53,54,2,1,92,87,299,258,95,90,278,234,179,403,107,3,557,102
15,La_liga,2014,16,Deportivo La Coruna,38,7,14,17,35,60,35,48,55,3,1,90,80,268,294,85,96,290,252,170,397,103,4,562,131
16,La_liga,2014,17,Granada,38,7,14,17,29,64,35,53,58,2,3,114,82,278,294,53,106,244,270,196,403,111,5,572,127
17,La_liga,2014,18,Eibar,38,9,8,21,34,55,35,55,48,2,3,80,74,277,292,87,109,251,198,154,357,103,5,569,124
18,La_liga,2014,19,Almeria,38,8,8,22,35,64,32,58,47,6,5,103,88,278,284,95,120,267,276,191,395,105,11,562,119
19,La_liga,2014,20,Cordoba,38,3,11,24,22,68,20,39,54,3,6,93,62,238,256,85,106,291,250,155,395,93,9,494,122
20,La_liga,2015,1,Barcelona,38,29,4,5,112,29,91,26,40,1,0,114,108,199,183,68,62,306,276,222,604,66,1,382,267
21,La_liga,2015,2,Real Madrid,38,28,6,4,110,34,90,29,39,2,3,138,119,209,213,71,73,218,290,257,710,68,5,422,290
22,La_liga,2015,3,Atletico Madrid,38,28,4,6,63,18,88,45,43,0,3,121,86,278,227,41,60,248,208,207,480,88,3,505,166
23,La_liga,2015,4,Villarreal,38,18,10,10,44,35,64,50,46,1,3,104,70,247,272,54,79,228,243,174,342,96,4,519,132
24,La_liga,2015,5,Athletic Club,38,18,8,12,58,45,62,36,47,3,3,125,82,256,245,53,85,273,231,207,454,83,6,501,163
25,La_liga,2015,6,Celta Vigo,38,17,9,12,51,59,60,43,66,2,5,120,76,259,270,75,87,266,268,196,444,109,7,529,155
26,La_liga,2015,7,Sevilla,38,14,10,14,51,50,52,46,49,2,6,139,114,303,254,77,96,257,261,253,460,95,8,557,182
27,La_liga,2015,8,Malaga,38,12,12,14,38,35,48,49,54,2,3,106,87,283,269,62,82,242,260,193,448,103,5,552,166
28,La_liga,2015,9,Real Sociedad,38,13,9,16,45,48,48,48,56,4,1,127,72,231,233,75,80,281,316,199,457,104,5,464,157
29,La_liga,2015,10,Real Betis,38,11,12,15,34,52,45,58,46,3,2,96,68,254,237,73,121,316,273,164,392,104,5,491,125
30,La_liga,2015,11,Valencia,38,11,11,16,46,48,44,34,67,2,5,112,73,285,281,82,101,301,321,185,396,101,7,566,138
31,La_liga,2015,12,Las Palmas,38,12,8,18,45,53,44,51,44,0,4,73,77,222,244,70,112,293,299,150,419,95,4,466,164
32,La_liga,2015,13,Espanyol,38,12,7,19,40,74,43,56,64,3,2,94,85,322,331,77,98,261,260,179,388,120,5,653,144
33,La_liga,2015,14,Eibar,38,11,10,17,49,61,43,49,54,1,3,102,71,296,297,62,92,221,214,173,419,103,4,593,153
34,La_liga,2015,15,Deportivo La Coruna,38,8,18,12,45,61,42,41,39,3,1,118,73,195,206,65,88,227,222,191,451,80,4,401,156
35,La_liga,2015,16,Sporting Gijon,38,10,9,19,40,62,39,48,50,1,5,93,74,238,286,100,111,216,253,167,371,98,6,524,122
36,La_liga,2015,17,Granada,38,10,9,19,46,69,39,62,71,3,4,85,63,271,314,83,94,265,258,148,429,133,7,585,130
37,La_liga,2015,18,Rayo Vallecano,38,9,11,18,52,73,38,56,52,6,4,104,123,279,267,81,111,254,243,227,501,108,10,546,179
38,La_liga,2015,19,Getafe,38,9,9,20,37,67,36,59,63,1,5,107,76,255,276,77,114,230,227,183,432,122,6,531,144
39,La_liga,2015,20,Levante,38,8,8,22,37,70,32,62,64,5,2,97,68,287,261,82,102,263,246,165,433,126,7,548,143
40,La_liga,2016,1,Real Madrid,38,29,6,3,106,41,93,43,29,2,0,124,99,224,201,71,75,280,261,223,661,72,2,425,265
41,La_liga,2016,2,Barcelona,38,28,6,4,116,37,90,30,43,0,1,146,95,207,214,58,101,271,328,241,648,73,1,421,268
42,La_liga,2016,3,Atletico Madrid,38,23,9,6,70,27,78,32,48,2,1,126,77,264,234,52,66,251,240,203,502,80,3,498,198
43,La_liga,2016,4,Sevilla,38,21,9,8,69,49,72,51,54,1,3,112,82,307,274,64,105,249,296,194,486,105,4,581,198
44,La_liga,2016,5,Villarreal,38,19,10,9,56,33,67,38,51,3,1,106,63,252,255,69,86,272,242,169,425,89,4,507,169
45,La_liga,2016,6,Real Sociedad,38,19,7,12,59,53,64,37,42,1,5,125,91,259,269,70,92,317,294,216,487,79,6,528,167
46,La_liga,2016,7,Athletic Club,38,19,6,13,53,43,63,40,47,0,2,124,96,249,250,55,72,262,280,220,478,87,2,499,186
47,La_liga,2016,8,Espanyol,38,15,11,12,49,50,56,35,45,1,1,94,44,296,271,67,107,247,252,138,343,80,2,567,129
48,La_liga,2016,9,Alaves,38,14,13,11,41,43,55,58,55,1,4,77,61,274,266,69,95,245,263,138,389,113,5,540,132
49,La_liga,2016,10,Eibar,38,15,9,14,56,51,54,34,57,3,4,104,91,248,267,64,95,209,197,195,449,91,7,515,177
50,La_liga,2016,11,Malaga,38,12,10,16,49,55,46,50,58,2,5,116,89,263,284,76,76,284,262,205,491,108,7,547,168
51,La_liga,2016,12,Valencia,38,13,7,18,56,65,46,52,56,2,4,107,72,274,276,85,87,287,297,179,447,108,6,550,169
52,La_liga,2016,13,Celta Vigo,38,13,6,19,53,69,45,46,52,2,6,76,52,251,262,87,103,242,283,128,405,98,8,513,148
53,La_liga,2016,14,Las Palmas,38,10,9,19,53,74,39,46,52,3,3,95,84,237,229,77,102,324,325,179,437,98,6,466,182
54,La_liga,2016,15,Real Betis,38,10,9,19,41,64,39,50,52,2,3,104,65,293,281,81,112,288,302,169,440,102,5,574,152
55,La_liga,2016,16,Deportivo La Coruna,38,8,12,18,43,61,36,40,52,0,4,110,82,285,251,70,99,263,270,192,461,92,4,536,145
56,La_liga,2016,17,Leganes,38,8,11,19,36,55,35,51,54,1,2,74,79,323,321,62,85,270,231,153,413,105,3,644,132
57,La_liga,2016,18,Sporting Gijon,38,7,10,21,42,72,31,54,58,2,2,99,78,282,285,100,102,257,269,177,375,112,4,567,135
58,La_liga,2016,19,Osasuna,38,4,10,24,40,94,22,55,43,1,2,96,47,285,282,90,111,207,218,143,389,98,3,567,143
59,La_liga,2016,20,Granada,38,4,8,26,30,82,20,50,59,5,1,90,58,273,280,105,144,227,236,148,380,109,6,553,124
60,La_liga,2017,1,Barcelona,38,28,9,1,99,29,93,30,37,1,1,115,100,191,192,58,77,267,279,215,580,67,2,383,272
61,La_liga,2017,2,Atletico Madrid,38,23,10,5,58,22,79,50,46,2,3,113,54,244,294,52,80,241,265,167,404,96,5,538,159
62,La_liga,2017,3,Real Madrid,38,22,10,6,94,44,76,24,41,2,2,163,115,204,232,70,78,238,293,278,698,65,4,436,281
63,La_liga,2017,4,Valencia,38,22,7,9,65,38,73,43,63,2,3,120,82,260,259,84,80,274,286,202,478,106,5,519,187
64,La_liga,2017,5,Villarreal,38,18,7,13,57,50,61,61,56,3,3,109,70,281,314,75,83,244,231,179,470,117,6,595,168
65,La_liga,2017,6,Real Betis,38,18,6,14,60,61,60,35,57,1,2,89,50,220,246,80,79,241,274,139,415,92,3,466,165
66,La_liga,2017,7,Sevilla,38,17,7,14,49,58,58,46,55,2,1,122,99,285,277,74,81,284,242,221,519,101,3,562,185
67,La_liga,2017,8,Getafe,38,15,10,13,42,33,55,63,69,3,2,105,76,327,347,62,71,261,254,181,370,132,5,674,135
68,La_liga,2017,9,Eibar,38,14,9,15,44,50,51,39,45,2,1,121,108,240,253,56,77,235,235,229,476,84,3,493,142
69,La_liga,2017,10,Girona,38,14,9,15,50,59,51,45,59,0,0,97,79,308,307,69,109,275,245,176,443,104,0,615,156
70,La_liga,2017,11,Celta Vigo,38,13,10,15,59,60,49,41,45,0,1,92,61,215,214,74,90,295,276,153,443,86,1,429,163
71,La_liga,2017,12,Espanyol,38,12,13,13,36,42,49,36,53,0,1,92,68,260,260,70,96,294,262,160,411,89,1,520,136
72,La_liga,2017,13,Real Sociedad,38,14,7,17,66,59,49,34,26,4,1,125,109,223,197,64,89,283,275,234,517,60,5,420,169
73,La_liga,2017,14,Alaves,38,15,2,21,40,50,47,65,44,4,0,73,65,311,292,75,106,281,260,138,383,109,4,603,135
74,La_liga,2017,15,Levante,38,11,13,14,44,58,46,52,58,4,3,91,91,270,283,84,103,242,224,182,410,110,7,553,126
75,La_liga,2017,16,Athletic Club,38,10,13,15,41,49,43,37,56,0,0,104,86,267,259,73,95,271,243,190,430,93,0,526,154
76,La_liga,2017,17,Leganes,38,12,7,19,34,51,43,40,65,3,2,93,59,296,292,65,97,265,261,152,396,105,5,588,137
77,La_liga,2017,18,Deportivo La Coruna,38,6,11,21,38,76,29,57,44,2,0,115,88,270,236,78,106,239,222,203,464,101,2,506,139
78,La_liga,2017,19,Las Palmas,38,5,7,26,24,74,22,37,52,1,2,108,67,219,263,99,123,335,358,175,410,89,3,482,128
79,La_liga,2017,20,Malaga,38,5,5,28,24,61,20,54,46,6,2,86,66,328,285,84,88,237,234,152,402,100,8,613,117
80,La_liga,2018,1,Barcelona,38,26,9,3,90,36,87,33,44,2,0,115,91,212,195,53,80,265,301,206,561,77,2,407,254
81,La_liga,2018,2,Atletico Madrid,38,22,10,6,55,29,76,52,51,1,4,108,109,232,244,54,83,252,225,217,442,103,5,476,160
82,La_liga,2018,3,Real Madrid,38,21,5,12,63,46,68,31,52,2,4,130,91,216,228,57,84,277,290,221,594,83,6,444,214
83,La_liga,2018,4,Valencia,38,15,16,7,51,35,61,43,47,0,3,127,69,242,221,59,95,259,281,196,478,90,3,463,165
84,La_liga,2018,5,Sevilla,38,17,8,13,62,47,59,60,58,1,5,106,117,265,271,76,81,253,241,223,532,118,6,536,180
85,La_liga,2018,6,Getafe,38,15,14,9,48,35,59,45,67,4,3,91,67,318,323,53,79,289,238,158,397,112,7,641,128
86,La_liga,2018,7,Espanyol,38,14,11,13,48,50,53,40,52,1,1,94,81,262,268,83,88,245,294,175,470,92,2,530,161
87,La_liga,2018,8,Athletic Club,38,13,14,11,41,45,53,63,57,2,3,101,52,287,294,58,61,266,256,153,387,120,5,581,139
88,La_liga,2018,9,Real Sociedad,38,13,11,14,45,46,50,42,40,1,3,103,75,240,251,61,86,284,286,178,425,82,4,491,144
89,La_liga,2018,10,Alaves,38,13,11,14,39,50,50,50,51,0,1,89,56,276,272,74,97,268,257,145,432,101,1,548,123
90,La_liga,2018,11,Real Betis,38,14,8,16,44,52,50,47,42,0,1,102,84,228,208,76,80,268,315,186,444,89,1,436,169
91,La_liga,2018,12,Eibar,38,11,14,13,46,50,47,40,43,1,1,129,95,252,263,62,71,213,213,224,527,83,2,515,157
92,La_liga,2018,13,Leganes,38,11,12,15,37,43,45,56,50,2,2,80,59,268,273,59,77,199,229,139,419,106,4,541,132
93,La_liga,2018,14,Levante,38,11,11,16,59,66,44,59,53,5,2,123,79,248,253,91,136,259,252,202,443,112,7,501,161
94,La_liga,2018,15,Villarreal,38,10,14,14,49,52,44,61,57,1,2,102,66,268,251,73,116,234,207,168,493,118,3,519,173
95,La_liga,2018,16,Celta Vigo,38,10,11,17,53,62,41,42,42,2,4,98,65,242,216,74,97,252,263,163,449,84,6,458,160
96,La_liga,2018,17,Real Valladolid,38,10,11,17,32,51,41,44,48,0,0,124,77,269,252,69,89,271,290,201,413,92,0,521,133
97,La_liga,2018,18,Girona,38,9,10,19,37,53,37,40,43,3,1,85,51,283,253,79,127,283,268,136,402,83,4,536,148
98,La_liga,2018,19,SD Huesca,38,7,12,19,43,65,33,60,54,1,2,117,52,296,284,69,110,243,225,169,474,114,3,580,151
99,La_liga,2018,20,Rayo Vallecano,38,8,8,22,41,70,32,53,53,4,4,94,92,276,291,84,100,231,249,186,455,106,8,567,149
100,EPL,2014,1,Chelsea,38,26,9,3,73,32,87,36,41,1,3,134,92,200,182,53,71,223,225,226,563,77,4,382,210
101,EPL,2014,2,Manchester City,38,24,7,7,83,38,79,35,42,1,1,170,103,234,211,52,77,144,168,273,668,77,2,445,228
102,EPL,2014,3,Arsenal,38,22,9,7,71,36,75,27,41,1,1,154,100,179,198,56,74,218,223,254,612,68,2,377,228
103,EPL,2014,4,Manchester United,38,20,10,8,62,37,70,31,33,1,4,109,104,223,230,60,80,223,193,213,509,64,5,453,179
104,EPL,2014,5,Tottenham,38,19,7,12,58,53,64,37,42,1,3,126,98,219,222,79,93,187,205,224,524,79,4,441,172
105,EPL,2014,6,Liverpool,38,18,8,12,52,48,62,29,37,2,1,111,87,190,195,63,80,255,233,198,590,66,3,385,194
106,EPL,2014,7,Southampton,38,18,6,14,54,33,60,23,34,2,1,118,91,232,236,51,63,197,220,209,506,57,3,468,170
107,EPL,2014,8,Swansea,38,16,8,14,46,49,56,25,23,1,4,83,68,195,203,80,112,246,246,151,422,48,5,398,147
108,EPL,2014,9,Stoke,38,15,9,14,48,45,54,33,49,0,1,112,80,240,246,71,72,221,207,192,501,82,1,486,136
109,EPL,2014,10,Crystal Palace,38,13,9,16,47,51,48,26,37,2,2,116,93,270,257,74,77,234,217,209,438,63,4,527,139
110,EPL,2014,11,West Ham,38,12,11,15,44,47,47,33,31,1,1,129,112,204,216,75,104,247,193,241,485,64,2,420,152
111,EPL,2014,12,Everton,38,12,11,15,48,50,47,27,39,0,2,105,89,185,203,55,73,233,237,194,484,66,2,388,166
112,EPL,2014,13,West Bromwich Albion,38,11,11,16,38,51,44,34,30,1,2,99,72,197,226,74,112,219,200,171,411,64,3,423,130
113,EPL,2014,14,Leicester,38,11,8,19,46,55,41,20,29,2,2,120,91,225,232,72,101,176,205,211,457,49,4,457,137
114,EPL,2014,15,Newcastle United,38,10,9,19,40,63,39,33,33,1,6,130,92,208,225,76,87,231,231,222,467,66,7,433,143
115,EPL,2014,16,Aston Villa,38,10,8,20,31,57,38,28,42,4,3,89,82,191,209,81,89,205,237,171,414,70,7,400,127
116,EPL,2014,17,Sunderland,38,7,17,14,31,53,38,45,49,1,1,112,73,218,217,79,118,243,222,185,404,94,2,435,129
117,EPL,2014,18,Hull,38,8,11,19,33,51,35,28,43,3,3,91,78,229,222,74,83,228,194,169,429,71,6,451,131
118,EPL,2014,19,Burnley,38,7,12,19,28,53,33,33,31,0,2,89,81,212,194,79,108,203,217,170,429,64,2,406,125
119,EPL,2014,20,Queens Park Rangers,38,8,6,24,42,73,30,36,39,1,2,95,84,222,225,95,121,216,200,179,533,75,3,447,151
120,EPL,2015,1,Leicester,38,23,12,3,68,36,81,17,31,1,2,91,106,179,226,69,74,202,171,197,523,48,3,405,181
121,EPL,2015,2,Arsenal,38,20,11,7,65,36,71,20,19,1,3,134,93,170,180,73,79,230,218,227,572,39,4,350,210
122,EPL,2015,3,Tottenham,38,19,13,6,69,35,70,30,42,0,0,142,112,216,236,57,64,209,194,254,661,72,0,452,250
123,EPL,2015,4,Manchester United,38,19,9,10,49,35,66,29,36,0,1,117,111,230,242,41,82,207,167,228,430,65,1,472,143
124,EPL,2015,5,Manchester City,38,19,9,10,71,41,66,25,36,0,0,155,102,197,212,66,59,204,198,257,612,61,0,409,210
125,EPL,2015,6,Southampton,38,18,9,11,59,41,63,27,30,3,3,114,110,192,224,68,72,194,181,224,519,57,6,416,169
126,EPL,2015,7,West Ham,38,16,14,8,65,51,62,20,36,3,2,114,110,186,195,78,90,236,231,224,556,56,5,381,184
127,EPL,2015,8,Liverpool,38,16,12,10,63,50,60,23,38,1,2,142,123,180,242,56,77,227,167,265,629,61,3,422,203
128,EPL,2015,9,Stoke,38,14,9,15,41,55,51,24,27,2,2,88,65,186,233,79,98,226,176,153,418,51,4,419,130
129,EPL,2015,10,Chelsea,38,12,14,12,59,53,50,27,31,3,3,127,113,208,200,94,85,253,244,240,526,58,6,408,173
130,EPL,2015,11,Swansea,38,12,11,15,42,52,47,35,27,1,0,77,86,173,219,69,100,243,225,163,442,62,1,392,136
131,EPL,2015,12,Everton,38,11,14,13,59,55,47,23,21,1,4,124,94,146,169,83,102,222,203,218,492,44,5,315,175
132,EPL,2015,13,Watford,38,12,9,17,40,50,45,38,36,2,1,95,71,210,250,74,100,232,165,166,445,74,3,460,136
133,EPL,2015,14,West Bromwich Albion,38,10,13,15,34,48,43,25,38,2,1,107,81,188,204,68,92,215,197,188,384,63,3,392,106
134,EPL,2015,15,Crystal Palace,38,11,9,18,39,51,42,32,28,1,0,126,93,215,250,77,95,256,194,219,466,60,1,465,152
135,EPL,2015,16,Bournemouth,38,11,9,18,45,67,42,25,27,0,1,129,92,175,187,75,79,219,183,221,463,52,1,362,144
136,EPL,2015,17,Sunderland,38,9,12,17,48,62,39,29,33,1,1,99,61,174,222,101,117,203,200,160,439,62,2,396,143
137,EPL,2015,18,Newcastle United,38,9,10,19,44,65,37,37,21,2,3,77,81,202,212,82,96,199,184,158,398,58,5,414,152
138,EPL,2015,19,Norwich,38,9,7,22,39,67,34,29,32,0,3,108,80,201,216,73,99,186,141,188,416,61,3,417,126
139,EPL,2015,20,Aston Villa,38,3,8,27,27,76,17,35,40,1,2,94,73,194,237,92,99,193,183,167,368,75,3,431,111
140,EPL,2016,1,Chelsea,38,30,3,5,85,33,93,32,40,0,0,129,89,185,209,57,48,250,241,218,580,72,0,394,204
141,EPL,2016,2,Tottenham,38,26,8,4,86,26,86,27,35,0,0,148,125,209,223,45,66,254,217,273,669,62,0,432,257
142,EPL,2016,3,Manchester City,38,23,9,6,80,39,78,32,39,4,0,151,129,188,207,44,62,211,224,280,633,71,4,395,217
143,EPL,2016,4,Liverpool,38,22,10,6,78,42,76,22,32,0,0,116,133,194,203,45,69,194,207,249,638,54,0,397,236
144,EPL,2016,5,Arsenal,38,23,6,9,77,44,75,34,33,3,0,132,95,200,197,80,87,212,188,227,565,67,3,397,200
145,EPL,2016,6,Manchester United,38,18,15,5,54,29,69,36,40,1,1,139,78,249,248,50,64,241,216,217,589,76,2,497,210
146,EPL,2016,7,Everton,38,17,10,11,62,44,61,36,35,1,1,120,76,215,244,58,90,216,216,196,498,71,2,459,192
147,EPL,2016,8,Bournemouth,38,12,10,16,55,67,46,24,27,1,2,98,93,173,193,75,114,262,233,191,446,51,3,366,160
148,EPL,2016,9,Southampton,38,12,10,16,41,48,46,23,35,2,0,108,92,206,218,53,75,216,211,200,548,58,2,424,179
149,EPL,2016,10,West Ham,38,12,9,17,47,64,45,47,30,1,4,90,82,192,216,88,93,237,240,172,496,77,5,408,138
150,EPL,2016,11,West Bromwich Albion,38,12,9,17,43,51,45,33,47,0,0,80,78,219,230,78,84,178,180,158,400,80,0,449,123
151,EPL,2016,12,Stoke,38,11,11,16,41,56,44,35,35,2,0,103,85,222,212,84,97,227,226,188,426,70,2,434,137
152,EPL,2016,13,Leicester,38,12,8,18,48,63,44,30,41,0,1,110,87,201,250,91,100,177,164,197,432,71,1,451,145
153,EPL,2016,14,Crystal Palace,38,12,5,21,50,63,41,32,45,0,0,102,100,230,239,80,97,239,237,202,438,77,0,469,138
154,EPL,2016,15,Swansea,38,12,5,21,45,70,41,30,26,0,0,119,77,190,211,77,108,236,202,196,390,56,0,401,146
155,EPL,2016,16,Watford,38,11,7,20,40,68,40,50,33,2,3,82,82,273,244,81,108,237,201,164,419,83,5,517,144
156,EPL,2016,17,Burnley,38,11,7,20,39,55,40,35,30,0,2,79,70,208,218,84,127,225,197,149,390,65,2,426,120
157,EPL,2016,18,Hull,38,9,7,22,37,80,34,32,35,2,3,73,106,219,184,112,103,210,193,179,396,67,5,403,127
158,EPL,2016,19,Middlesbrough,38,5,13,20,27,53,28,38,38,0,1,93,48,210,268,67,105,205,208,141,349,76,1,478,100
159,EPL,2016,20,Sunderland,38,6,6,26,29,69,24,35,41,2,2,86,74,221,216,116,132,203,203,160,387,76,4,437,121
160,EPL,2017,1,Manchester City,38,32,4,2,106,27,100,26,32,1,1,138,146,169,175,40,47,180,186,284,664,58,2,344,261
161,EPL,2017,2,Manchester United,38,25,6,7,68,28,81,29,35,0,1,117,103,204,200,65,81,219,216,220,513,64,1,404,181
162,EPL,2017,3,Tottenham,38,23,8,7,74,36,77,20,29,0,2,143,103,177,207,62,64,202,205,246,622,49,2,384,217
163,EPL,2017,4,Liverpool,38,21,12,5,84,38,75,18,26,0,1,134,96,166,178,37,66,161,163,230,640,44,1,344,233
164,EPL,2017,5,Chelsea,38,21,7,10,62,38,70,19,22,3,1,148,82,183,180,51,69,222,195,230,606,41,4,363,220
165,EPL,2017,6,Arsenal,38,19,6,13,74,51,63,25,32,1,1,132,93,186,197,70,79,197,194,225,593,57,2,383,234
166,EPL,2017,7,Burnley,38,14,12,12,36,39,54,27,38,0,0,94,73,167,183,80,84,227,214,167,379,65,0,350,127
167,EPL,2017,8,Everton,38,13,10,15,44,58,49,28,23,1,2,81,69,234,225,81,102,196,187,150,360,51,3,459,122
168,EPL,2017,9,Leicester,38,12,11,15,56,60,47,22,30,2,3,112,91,180,185,69,99,195,172,203,422,52,5,365,148
169,EPL,2017,10,Crystal Palace,38,11,11,16,45,55,44,38,33,0,0,104,105,215,210,81,95,215,199,209,475,71,0,425,151
170,EPL,2017,11,Bournemouth,38,11,11,16,45,61,44,31,24,1,0,115,103,165,174,85,92,207,232,218,467,55,1,339,158
171,EPL,2017,12,Newcastle United,38,12,8,18,39,47,44,23,29,2,0,83,84,207,202,65,92,205,184,167,449,52,2,409,150
172,EPL,2017,13,West Ham,38,10,12,16,48,68,42,34,38,0,2,93,68,193,186,75,115,237,226,161,373,72,2,379,133
173,EPL,2017,14,Watford,38,11,8,19,44,64,41,41,22,2,2,96,88,224,217,81,79,206,187,184,440,63,4,441,132
174,EPL,2017,15,Brighton,38,9,13,16,34,54,40,37,17,1,1,90,73,198,215,87,94,152,141,163,383,54,2,413,118
175,EPL,2017,16,Huddersfield,38,9,10,19,28,58,37,26,35,2,1,102,63,180,216,77,88,180,197,165,360,61,3,396,111
176,EPL,2017,17,Southampton,38,7,15,16,37,56,36,29,34,0,2,125,102,190,226,74,96,200,197,227,451,63,2,416,145
177,EPL,2017,18,Stoke,38,7,12,19,35,68,33,30,32,1,0,80,56,219,217,97,123,198,194,136,382,62,1,436,131
178,EPL,2017,19,Swansea,38,8,9,21,28,56,33,24,27,0,1,95,55,196,181,86,105,213,201,150,336,51,1,377,104
179,EPL,2017,20,West Bromwich Albion,38,6,13,19,31,56,31,35,37,0,1,101,75,230,210,68,89,172,193,176,375,72,1,440,114
180,EPL,2018,1,Manchester City,38,32,2,4,95,23,98,17,27,0,1,143,144,162,166,40,43,155,165,287,683,44,1,328,260
181,EPL,2018,2,Liverpool,38,30,7,1,89,22,97,13,24,1,1,133,116,149,166,40,57,175,191,249,574,37,2,315,226
182,EPL,2018,3,Chelsea,38,21,9,8,63,39,72,20,29,0,0,120,95,154,185,49,78,202,229,215,606,49,0,339,198
183,EPL,2018,4,Tottenham,38,23,2,13,67,39,71,20,36,0,3,102,92,174,201,83,76,177,209,194,536,56,3,375,189
184,EPL,2018,5,Arsenal,38,21,7,10,73,51,70,40,32,0,2,128,84,218,194,75,108,256,213,212,466,72,2,412,170
185,EPL,2018,6,Manchester United,38,19,9,10,65,54,66,32,41,1,3,116,84,213,220,81,92,209,200,200,526,73,4,433,225
186,EPL,2018,7,Wolverhampton Wanderers,38,16,9,13,47,46,57,33,39,0,1,109,86,198,211,72,76,165,169,195,474,72,1,409,151
187,EPL,2018,8,Everton,38,15,9,14,54,46,54,24,31,0,4,119,96,218,214,68,69,226,214,215,495,55,4,432,169
188,EPL,2018,9,West Ham,38,15,7,16,52,55,52,28,31,0,1,108,79,165,166,87,113,199,202,187,441,59,1,331,157
189,EPL,2018,10,Leicester,38,15,7,16,51,48,52,33,24,2,3,108,102,184,167,62,77,191,210,210,515,57,5,351,184
190,EPL,2018,11,Watford,38,14,8,16,52,59,50,38,39,3,1,91,86,221,212,87,97,194,209,177,434,77,4,433,151
191,EPL,2018,12,Crystal Palace,38,14,7,17,51,53,49,25,33,1,1,130,75,180,206,66,98,211,197,205,491,58,2,386,146
192,EPL,2018,13,Newcastle United,38,12,9,17,42,48,45,25,32,1,1,112,69,203,219,60,88,189,160,181,444,57,2,422,142
193,EPL,2018,14,Bournemouth,38,13,6,19,56,70,45,36,24,1,0,96,95,187,152,82,93,232,223,191,447,60,1,339,163
194,EPL,2018,15,Burnley,38,11,7,20,45,68,40,33,42,0,1,80,60,184,175,94,116,193,183,140,359,75,1,359,115
195,EPL,2018,16,Southampton,38,9,12,17,45,65,39,39,32,2,1,101,92,219,201,79,100,188,163,193,480,71,3,420,162
196,EPL,2018,17,Brighton,38,9,9,20,35,60,36,30,30,2,2,90,66,221,242,79,96,167,155,156,365,60,4,463,108
197,EPL,2018,18,Cardiff,38,10,4,24,34,69,34,33,32,0,1,95,73,195,189,92,120,232,183,168,417,65,1,384,126
198,EPL,2018,19,Fulham,38,7,5,26,34,81,26,34,34,1,1,102,59,199,224,108,117,159,195,161,453,68,2,423,149
199,EPL,2018,20,Huddersfield,38,3,7,28,22,76,16,27,28,3,1,85,77,214,206,89,102,196,188,162,400,55,4,420,118
200,Bundesliga,2014,1,Bayern Munich,34,25,4,5,80,18,79,11,26,2,0,120,102,176,238,47,48,215,277,222,583,37,2,414,238
201,Bundesliga,2014,2,Wolfsburg,34,20,9,5,72,38,69,24,20,0,1,100,84,218,236,61,83,236,231,184,522,44,1,454,205
202,Bundesliga,2014,3,Borussia M.Gladbach,34,19,9,6,53,26,66,24,30,2,0,92,65,211,205,59,92,240,226,157,424,54,2,416,174
203,Bundesliga,2014,4,Bayer Leverkusen,34,17,10,7,62,37,61,36,40,2,2,112,90,291,318,56,72,268,268,202,554,76,4,609,192
204,Bundesliga,2014,5,Augsburg,34,15,4,15,43,43,49,26,35,2,1,63,86,278,274,88,82,289,255,149,458,61,3,552,150
205,Bundesliga,2014,6,Schalke 04,34,13,9,12,42,40,48,27,38,3,1,68,72,246,271,79,95,258,246,140,418,65,4,517,153
206,Bundesliga,2014,7,Borussia Dortmund,34,13,7,14,47,42,46,26,28,0,0,107,99,229,225,37,75,219,232,206,567,54,0,454,190
207,Bundesliga,2014,8,Hoffenheim,34,12,8,14,49,55,44,34,32,0,2,90,75,276,324,74,83,303,308,165,501,66,2,600,171
208,Bundesliga,2014,9,Werder Bremen,34,11,10,13,50,65,43,35,32,0,2,100,52,293,295,62,101,267,254,152,415,67,2,588,170
209,Bundesliga,2014,10,Eintracht Frankfurt,34,11,10,13,56,62,43,43,41,1,2,83,74,288,281,98,97,323,280,157,426,84,3,569,171
210,Bundesliga,2014,12,Mainz 05,34,9,13,12,45,47,40,25,28,2,0,91,57,238,257,64,111,270,276,148,437,53,2,495,145
211,Bundesliga,2014,13,Hannover 96,34,9,10,15,40,56,37,36,36,2,3,101,80,265,303,69,92,263,248,181,384,72,5,568,145
212,Bundesliga,2014,14,VfB Stuttgart,34,9,9,16,42,60,36,27,32,3,2,98,87,256,248,76,103,275,263,185,411,59,5,504,138
213,Bundesliga,2014,15,Hamburger SV,34,9,8,17,25,50,35,40,43,2,3,71,53,316,302,79,110,273,235,124,364,83,5,618,114
214,Bundesliga,2014,16,Hertha Berlin,34,9,8,17,36,52,35,34,38,1,3,67,64,289,300,68,88,273,261,131,297,72,4,589,107
215,Bundesliga,2014,17,Freiburg,34,7,13,14,36,47,34,27,36,3,1,89,65,238,254,99,101,263,240,154,385,63,4,492,158
216,Bundesliga,2014,18,Paderborn,34,7,10,17,31,65,31,15,36,2,1,106,70,224,260,73,104,314,248,176,454,51,3,484,140
217,Bundesliga,2015,1,Bayern Munich,34,28,4,2,80,17,88,20,24,0,1,141,87,187,193,43,40,202,218,228,607,44,1,380,257
218,Bundesliga,2015,2,Borussia Dortmund,34,24,6,4,82,34,78,15,24,0,0,114,77,176,215,47,63,205,266,191,529,39,0,391,212
219,Bundesliga,2015,3,Bayer Leverkusen,34,18,6,10,56,40,60,29,36,2,2,118,99,249,276,59,84,264,256,217,485,65,4,525,185
220,Bundesliga,2015,4,Borussia M.Gladbach,34,17,4,13,67,50,55,24,21,2,1,77,69,239,222,77,81,253,228,146,454,45,3,461,191
221,Bundesliga,2015,5,Schalke 04,34,15,7,12,51,49,52,32,32,0,1,91,79,248,258,75,91,252,210,170,487,64,1,506,163
222,Bundesliga,2015,6,Mainz 05,34,14,8,12,46,42,50,24,29,1,0,82,63,265,263,78,87,274,235,145,383,53,1,528,150
223,Bundesliga,2015,7,Hertha Berlin,34,14,8,12,42,42,50,25,41,0,3,82,61,248,233,58,87,283,253,143,331,66,3,481,128
224,Bundesliga,2015,8,Wolfsburg,34,12,9,13,47,49,45,23,32,1,2,102,66,213,244,70,82,235,229,168,489,55,3,457,194
225,Bundesliga,2015,10,Hamburger SV,34,11,8,15,40,46,41,40,33,0,3,64,66,275,301,86,89,233,250,130,373,73,3,576,136
226,Bundesliga,2015,11,Ingolstadt,34,10,10,14,33,42,40,31,48,1,1,73,70,233,293,55,70,293,306,143,422,79,2,526,128
227,Bundesliga,2015,12,Darmstadt,34,9,11,14,38,53,38,44,42,0,1,58,59,256,301,75,84,277,272,117,346,86,1,557,116
228,Bundesliga,2015,13,Werder Bremen,34,10,8,16,50,65,38,36,41,1,1,82,66,270,250,70,103,273,258,148,453,77,2,520,151
229,Bundesliga,2015,14,Augsburg,34,9,11,14,42,52,38,33,48,2,0,74,54,243,289,81,105,233,225,128,444,81,2,532,150
230,Bundesliga,2015,15,Hoffenheim,34,9,10,15,39,54,37,28,28,1,2,74,63,221,248,93,109,257,241,137,379,56,3,469,134
231,Bundesliga,2015,16,Eintracht Frankfurt,34,9,9,16,34,52,36,47,46,1,2,94,67,268,249,88,93,292,235,161,368,93,3,517,136
232,Bundesliga,2015,17,VfB Stuttgart,34,9,6,19,50,75,33,37,27,3,2,127,97,243,263,101,107,235,212,224,498,64,5,506,188
233,Bundesliga,2015,18,Hannover 96,34,7,4,23,31,62,25,30,36,0,0,74,77,264,256,98,113,241,218,151,380,66,0,520,126
234,Bundesliga,2016,1,Bayern Munich,34,25,7,2,89,22,82,13,34,0,0,138,105,169,191,52,46,186,238,243,621,47,0,360,229
235,Bundesliga,2016,2,RasenBallsport Leipzig,34,20,7,7,66,39,67,25,41,1,1,96,85,246,277,46,53,236,248,181,442,66,2,523,173
236,Bundesliga,2016,3,Borussia Dortmund,34,18,10,6,72,40,64,27,28,1,1,117,91,190,223,48,78,300,256,208,534,55,2,413,204
237,Bundesliga,2016,4,Hoffenheim,34,16,14,4,64,37,62,28,35,0,1,72,72,239,275,74,77,284,265,144,498,63,1,514,181
238,Bundesliga,2016,5,Hertha Berlin,34,15,4,15,43,47,49,29,34,2,1,69,48,226,247,67,85,271,224,117,345,63,3,473,126
239,Bundesliga,2016,7,Freiburg,34,14,6,14,42,60,48,28,28,1,0,77,63,200,245,82,79,227,243,140,403,56,1,445,145
240,Bundesliga,2016,8,Werder Bremen,34,13,6,15,61,64,45,27,40,1,1,63,65,250,226,82,110,290,230,128,377,67,2,476,154
241,Bundesliga,2016,9,Borussia M.Gladbach,34,12,9,13,45,49,45,23,23,0,2,86,56,191,228,66,89,254,203,142,410,46,2,419,146
242,Bundesliga,2016,10,Schalke 04,34,11,10,13,45,40,43,27,42,1,2,86,74,251,257,47,74,234,221,160,442,69,3,508,137
243,Bundesliga,2016,11,Eintracht Frankfurt,34,11,9,14,36,43,42,44,38,4,2,91,59,271,267,58,65,227,253,150,380,82,6,538,124
244,Bundesliga,2016,12,Bayer Leverkusen,34,11,8,15,53,55,41,17,33,4,0,81,68,226,252,80,81,221,201,149,445,50,4,478,177
245,Bundesliga,2016,13,Augsburg,34,9,11,14,35,51,38,36,30,2,1,52,54,241,253,74,100,239,219,106,370,66,3,494,127
246,Bundesliga,2016,14,Hamburger SV,34,10,8,16,33,61,38,36,37,2,3,85,71,259,305,65,87,252,222,156,359,73,5,564,113
247,Bundesliga,2016,15,Mainz 05,34,10,7,17,44,55,37,38,29,2,5,100,90,234,259,82,80,256,233,190,414,67,7,493,152
248,Bundesliga,2016,16,Wolfsburg,34,10,7,17,34,52,37,30,35,2,1,84,84,251,262,85,79,253,250,168,426,65,3,513,143
249,Bundesliga,2016,17,Ingolstadt,34,8,8,18,36,57,32,31,38,3,3,89,69,264,290,80,79,276,289,158,457,69,6,554,162
250,Bundesliga,2016,18,Darmstadt,34,7,4,23,28,63,25,31,36,1,4,52,76,280,236,81,114,277,185,128,335,67,5,516,94
251,Bundesliga,2017,1,Bayern Munich,34,27,3,4,92,28,84,14,28,0,0,119,104,149,199,50,48,193,218,223,589,42,0,348,236
252,Bundesliga,2017,2,Schalke 04,34,18,9,7,53,37,63,27,35,2,0,61,79,261,271,64,69,256,247,140,404,62,2,532,165
253,Bundesliga,2017,3,Bayer Leverkusen,34,15,10,9,58,44,55,31,27,3,1,106,65,206,232,48,72,239,252,171,509,58,4,438,172
254,Bundesliga,2017,4,Hoffenheim,34,15,10,9,66,48,55,28,40,0,0,72,86,218,269,63,85,226,212,158,473,68,0,487,180
255,Bundesliga,2017,5,Borussia Dortmund,34,15,10,9,64,47,55,21,20,2,1,88,74,197,195,73,83,216,206,162,489,41,3,392,182
256,Bundesliga,2017,6,RasenBallsport Leipzig,34,15,8,11,57,53,53,14,34,2,4,77,90,203,222,69,82,241,247,167,486,48,6,425,176
257,Bundesliga,2017,7,VfB Stuttgart,34,15,6,13,36,36,51,30,29,1,1,78,64,220,223,64,96,221,210,142,368,59,2,443,129
258,Bundesliga,2017,8,Eintracht Frankfurt,34,14,7,13,45,45,49,37,35,2,0,92,65,252,258,57,82,235,223,157,389,72,2,510,147
259,Bundesliga,2017,9,Borussia M.Gladbach,34,13,8,13,47,52,47,21,26,0,0,110,58,196,192,80,97,222,194,168,454,47,0,388,156
260,Bundesliga,2017,10,Hertha Berlin,34,10,13,11,43,46,43,17,30,1,2,74,53,218,251,74,80,232,233,127,318,47,3,469,134
261,Bundesliga,2017,11,Werder Bremen,34,10,12,12,37,40,42,26,29,0,0,93,88,233,276,75,87,237,198,181,433,55,0,509,153
262,Bundesliga,2017,12,Augsburg,34,10,11,13,43,46,41,33,35,0,2,105,69,219,244,88,82,220,197,174,433,68,2,463,146
263,Bundesliga,2017,13,Hannover 96,34,10,9,15,44,54,39,27,36,0,0,82,52,240,235,74,105,257,243,134,434,63,0,475,146
264,Bundesliga,2017,14,Mainz 05,34,9,9,16,38,52,36,23,40,1,2,76,72,244,261,47,99,222,215,148,416,63,3,505,146
265,Bundesliga,2017,15,Freiburg,34,8,12,14,32,56,36,30,24,1,4,72,55,225,207,56,102,237,192,127,376,54,5,432,117
266,Bundesliga,2017,16,Wolfsburg,34,6,15,13,36,48,33,32,30,4,2,72,59,208,220,73,83,270,225,131,355,62,6,428,117
267,Bundesliga,2017,17,Hamburger SV,34,8,7,19,29,53,31,34,26,3,1,116,87,235,238,65,78,253,210,203,398,60,4,473,137
268,Bundesliga,2018,1,Bayern Munich,34,24,6,4,88,32,78,18,26,1,1,151,136,130,148,37,46,170,172,287,636,44,2,278,255
269,Bundesliga,2018,2,Borussia Dortmund,34,23,7,4,81,44,76,16,24,2,1,81,87,134,145,64,70,213,180,168,451,40,3,279,184
270,Bundesliga,2018,3,RasenBallsport Leipzig,34,19,9,6,63,29,66,30,31,0,1,90,100,203,239,61,62,194,196,190,492,61,1,442,182
271,Bundesliga,2018,4,Bayer Leverkusen,34,18,4,12,69,52,58,23,27,0,1,108,81,164,185,69,76,206,178,189,516,50,1,349,197
272,Bundesliga,2018,5,Borussia M.Gladbach,34,16,7,11,55,42,55,18,25,0,0,101,88,145,165,74,81,197,161,189,457,43,0,310,158
273,Bundesliga,2018,6,Wolfsburg,34,16,7,11,62,50,55,23,39,0,0,101,74,159,181,84,77,213,224,175,422,62,0,340,166
274,Bundesliga,2018,7,Eintracht Frankfurt,34,15,9,10,60,48,54,27,33,2,1,107,72,189,200,73,101,181,162,179,413,60,3,389,153
275,Bundesliga,2018,8,Werder Bremen,34,14,11,9,58,49,53,24,40,1,2,87,81,198,207,79,77,158,192,168,467,64,3,405,176
276,Bundesliga,2018,9,Hoffenheim,34,13,12,9,70,52,51,29,40,0,2,99,83,205,246,80,97,177,170,182,606,69,2,451,225
277,Bundesliga,2018,11,Hertha Berlin,34,11,10,13,49,57,43,33,34,2,3,75,72,222,196,81,84,197,177,147,401,67,5,418,149
278,Bundesliga,2018,12,Mainz 05,34,12,7,15,46,57,43,33,24,0,0,75,75,208,196,76,99,177,189,150,495,57,0,404,151
279,Bundesliga,2018,13,Freiburg,34,8,12,14,46,61,36,25,31,2,1,78,73,199,188,84,91,197,210,151,422,56,3,387,163
280,Bundesliga,2018,14,Schalke 04,34,8,9,17,37,55,33,32,41,4,1,73,82,207,215,86,82,202,202,155,418,73,5,422,133
281,Bundesliga,2018,15,Augsburg,34,8,8,18,51,71,32,21,34,0,1,79,63,216,223,91,103,177,173,142,458,55,1,439,165
282,Bundesliga,2018,16,VfB Stuttgart,34,7,7,20,32,70,28,31,35,2,3,90,80,181,169,78,102,200,199,170,405,66,5,350,114
283,Bundesliga,2018,17,Hannover 96,34,5,6,23,31,71,21,28,36,0,4,72,71,223,173,110,120,221,198,143,380,64,4,396,122
284,Bundesliga,2018,18,Nuernberg,34,3,10,21,26,68,19,31,28,0,4,87,64,193,183,77,106,197,182,151,355,59,4,376,104
285,Serie_A,2014,1,Juventus,38,26,9,3,72,24,87,31,41,2,3,122,99,252,272,49,52,254,285,221,603,72,5,524,202
286,Serie_A,2014,2,Roma,38,19,13,6,54,31,70,41,58,4,1,120,104,263,256,59,59,266,273,224,523,99,5,519,176
287,Serie_A,2014,3,Lazio,38,21,6,11,71,38,69,45,59,5,4,119,89,337,341,59,69,237,242,208,543,104,9,678,216
288,Serie_A,2014,4,Fiorentina,38,18,10,10,61,46,64,36,45,0,3,144,103,232,305,63,91,290,289,247,617,81,3,537,201
289,Serie_A,2014,5,Napoli,38,18,9,11,70,54,63,38,39,3,3,141,110,271,253,63,65,260,248,251,622,77,6,524,233
290,Serie_A,2014,6,Genoa,38,16,11,11,62,47,59,46,56,2,4,127,105,294,340,98,88,325,324,232,488,102,6,634,177
291,Serie_A,2014,7,Sampdoria,38,13,17,8,48,42,56,46,50,1,2,122,90,310,304,61,99,343,284,212,499,96,3,614,156
292,Serie_A,2014,8,Inter,38,14,13,11,59,48,55,38,55,2,3,132,102,273,287,68,78,243,253,234,618,93,5,560,184
293,Serie_A,2014,9,Torino,38,14,12,12,48,45,54,39,57,0,3,107,73,247,296,63,85,261,288,180,542,96,3,543,170
294,Serie_A,2014,10,AC Milan,38,13,13,12,56,50,52,42,40,4,9,112,84,250,291,69,92,334,303,196,449,82,13,541,148
295,Serie_A,2014,11,Palermo,38,12,13,13,53,55,49,41,42,1,3,119,77,289,293,78,96,301,271,196,479,83,4,582,152
296,Serie_A,2014,12,Sassuolo,38,12,13,13,49,57,49,55,46,2,7,104,60,299,288,80,97,355,337,164,447,101,9,587,152
297,Serie_A,2014,13,Verona,38,11,13,14,49,65,46,42,54,6,1,109,66,246,277,101,102,266,269,175,458,96,7,523,156
298,Serie_A,2014,14,Chievo,38,10,13,15,28,41,43,41,41,2,1,97,68,321,305,65,96,305,293,165,458,82,3,626,138
299,Serie_A,2014,15,Empoli,38,8,18,12,46,52,42,25,33,3,1,148,77,239,250,65,97,332,295,225,512,58,4,489,167
300,Serie_A,2014,16,Udinese,38,10,11,17,43,56,41,40,51,3,3,98,82,247,285,94,97,272,260,180,423,91,6,532,121
301,Serie_A,2014,17,Atalanta,38,7,16,15,38,57,37,49,54,7,2,105,88,307,322,93,114,349,289,193,463,103,9,629,132
302,Serie_A,2014,18,Cagliari,38,8,10,20,48,68,34,58,50,1,5,106,95,295,299,100,86,314,333,201,496,108,6,594,179
303,Serie_A,2014,19,Parma,38,6,8,24,33,75,26,58,40,4,4,86,66,353,306,82,116,291,220,152,414,98,8,659,111
304,Serie_A,2014,20,Cesena,38,4,12,22,36,73,24,51,51,2,2,66,66,309,322,87,110,294,278,132,357,102,4,631,115
305,Serie_A,2015,1,Juventus,38,29,4,5,75,20,91,41,49,1,5,118,94,267,304,35,60,287,322,212,599,90,6,571,215
306,Serie_A,2015,2,Napoli,38,25,7,6,80,32,82,28,40,0,2,132,92,199,242,34,54,240,266,224,656,68,2,441,243
307,Serie_A,2015,3,Roma,38,23,11,4,83,41,80,31,48,2,3,130,106,284,248,64,84,246,250,236,585,79,5,532,216
308,Serie_A,2015,4,Inter,38,20,7,11,50,38,67,48,42,5,7,140,105,261,243,64,89,272,255,245,516,90,12,504,167
309,Serie_A,2015,5,Fiorentina,38,18,10,10,60,42,64,35,58,2,1,127,81,262,274,40,74,315,317,208,573,93,3,536,180
310,Serie_A,2015,6,Sassuolo,38,16,13,9,49,40,61,42,48,5,2,111,91,265,306,68,74,340,315,202,486,90,7,571,153
311,Serie_A,2015,7,AC Milan,38,15,12,11,49,43,57,41,51,1,2,124,106,286,299,62,81,289,330,230,550,92,3,585,173
312,Serie_A,2015,8,Lazio,38,15,9,14,52,52,54,48,46,2,8,128,115,282,312,75,78,248,256,243,511,94,10,594,147
313,Serie_A,2015,9,Chievo,38,13,11,14,43,45,50,51,53,0,4,80,76,304,328,68,109,258,299,156,423,104,4,632,129
314,Serie_A,2015,10,Genoa,38,13,7,18,45,48,46,42,40,5,4,115,82,293,339,75,96,317,266,197,468,82,9,632,149
315,Serie_A,2015,11,Empoli,38,12,10,16,40,49,46,35,57,2,4,96,73,245,262,74,90,355,364,169,477,92,6,507,148
316,Serie_A,2015,12,Atalanta,38,11,12,15,41,47,45,41,54,4,10,118,72,301,335,69,88,299,319,190,454,95,14,636,137
317,Serie_A,2015,13,Torino,38,12,9,17,52,55,45,43,52,3,0,91,90,336,320,75,71,278,238,181,471,95,3,656,176
318,Serie_A,2015,14,Bologna,38,11,9,18,33,45,42,49,39,2,5,106,78,298,237,69,87,281,250,184,387,88,7,535,114
319,Serie_A,2015,15,Sampdoria,38,10,10,18,48,61,40,52,50,3,4,99,73,291,260,97,110,295,291,172,430,102,7,551,152
320,Serie_A,2015,16,Palermo,38,10,9,19,38,65,39,47,49,3,3,101,63,302,319,101,100,291,288,164,412,96,6,621,122
321,Serie_A,2015,17,Udinese,38,10,9,19,35,60,39,47,51,6,1,108,84,303,272,73,96,304,267,192,444,98,7,575,145
322,Serie_A,2015,18,Carpi,38,9,11,18,37,57,38,50,55,3,3,88,90,327,307,82,88,304,274,178,426,105,6,634,132
323,Serie_A,2015,19,Frosinone,38,8,7,23,35,76,31,52,56,2,3,93,77,325,300,89,139,306,288,170,486,108,5,625,124
324,Serie_A,2015,20,Verona,38,5,13,20,34,63,28,43,45,2,5,122,87,317,295,90,92,277,293,209,451,88,7,612,142
325,Serie_A,2016,1,Juventus,38,29,4,5,77,27,91,29,41,0,0,122,100,233,240,41,67,269,319,222,583,70,0,473,221
326,Serie_A,2016,2,Roma,38,28,3,7,90,38,87,26,38,1,0,144,115,213,249,71,83,248,266,259,676,64,1,462,234
327,Serie_A,2016,3,Napoli,38,26,8,4,94,39,86,24,34,0,2,156,110,176,200,58,68,217,243,266,670,58,2,376,262
328,Serie_A,2016,4,Atalanta,38,21,9,8,62,41,72,40,45,0,3,132,97,277,326,64,86,267,301,229,534,85,3,603,201
329,Serie_A,2016,5,Lazio,38,21,7,10,74,51,70,41,49,3,1,138,99,275,268,72,91,227,220,237,584,90,4,543,211
330,Serie_A,2016,6,AC Milan,38,18,9,11,57,45,63,40,41,3,9,132,110,258,263,80,108,270,270,242,555,81,12,521,191
331,Serie_A,2016,7,Inter,38,19,5,14,72,49,62,32,42,1,4,164,142,269,271,70,91,256,285,306,630,74,5,540,208
332,Serie_A,2016,8,Fiorentina,38,16,12,10,63,57,60,45,47,3,3,127,107,266,269,76,94,273,282,234,609,92,6,535,226
333,Serie_A,2016,9,Torino,38,13,14,11,71,66,53,31,49,0,4,121,99,294,293,91,85,224,273,220,573,80,4,587,184
334,Serie_A,2016,10,Sassuolo,38,14,7,17,60,61,49,48,42,1,1,109,111,276,242,84,116,293,256,220,441,90,2,518,171
335,Serie_A,2016,11,Sampdoria,38,12,12,14,49,55,48,35,38,0,4,105,90,246,265,77,102,273,253,195,501,73,4,511,167
336,Serie_A,2016,12,Cagliari,38,14,5,19,55,76,47,47,50,2,5,69,75,300,257,98,114,269,252,144,421,97,7,557,174
337,Serie_A,2016,13,Udinese,38,12,9,17,47,56,45,41,43,2,0,89,90,238,246,71,86,276,250,179,434,84,2,484,155
338,Serie_A,2016,14,Chievo,38,12,7,19,43,61,43,38,44,1,3,81,66,284,271,86,105,287,269,147,407,82,4,555,129
339,Serie_A,2016,15,Bologna,38,11,8,19,40,58,41,38,46,5,6,94,62,240,246,75,113,264,268,156,422,84,11,486,145
340,Serie_A,2016,16,Genoa,38,9,9,20,38,64,36,48,41,5,3,84,108,314,309,72,100,241,220,192,443,89,8,623,147
341,Serie_A,2016,17,Crotone,38,9,7,22,34,58,34,40,47,1,3,78,78,299,286,100,116,250,243,156,399,87,4,585,130
342,Serie_A,2016,18,Empoli,38,8,8,22,29,61,32,53,54,1,1,88,83,299,239,96,117,340,291,171,362,107,2,538,127
343,Serie_A,2016,19,Palermo,38,6,8,24,33,77,26,47,46,4,5,88,74,283,281,96,110,279,272,162,381,93,9,564,118
344,Serie_A,2016,20,Pescara,38,2,9,27,35,83,15,45,47,3,1,93,90,272,279,97,120,277,279,183,442,92,4,551,146
345,Serie_A,2017,1,Juventus,38,30,5,3,86,24,95,30,36,0,1,97,89,215,210,38,57,257,261,186,554,66,1,425,205
346,Serie_A,2017,2,Napoli,38,28,7,3,77,29,91,23,35,1,2,128,113,175,174,46,52,195,195,241,652,58,3,349,256
347,Serie_A,2017,3,Roma,38,23,8,7,61,28,77,22,26,2,2,152,111,194,202,68,73,206,254,263,644,48,4,396,213
348,Serie_A,2017,4,Inter,38,20,12,6,66,30,72,29,40,1,0,148,142,221,232,52,66,220,202,290,570,69,1,453,206
349,Serie_A,2017,5,Lazio,38,21,9,8,89,49,72,31,46,4,2,125,92,211,224,79,83,183,195,217,554,77,6,435,216
350,Serie_A,2017,6,AC Milan,38,18,10,10,56,42,64,30,45,2,5,144,100,261,237,54,81,233,280,244,609,75,7,498,224
351,Serie_A,2017,7,Atalanta,38,16,12,10,57,39,60,30,37,2,2,110,119,229,262,51,66,258,241,229,573,67,4,491,197
352,Serie_A,2017,8,Fiorentina,38,16,9,13,54,46,57,40,48,2,4,121,89,284,263,63,91,234,223,210,616,88,6,547,193
353,Serie_A,2017,9,Sampdoria,38,16,6,16,56,60,54,30,39,0,2,114,110,205,219,84,117,263,245,224,476,69,2,424,172
354,Serie_A,2017,10,Torino,38,13,15,10,54,46,54,34,44,1,3,81,92,260,305,72,91,270,269,173,443,78,4,565,156
355,Serie_A,2017,11,Sassuolo,38,11,10,17,29,59,43,44,45,3,4,103,93,253,230,75,105,300,286,196,495,89,7,483,143
356,Serie_A,2017,12,Genoa,38,11,8,19,33,43,41,40,36,2,3,103,80,274,286,87,88,235,263,183,411,76,5,560,126
357,Serie_A,2017,13,Udinese,38,12,4,22,48,63,40,37,35,3,1,93,84,266,263,80,96,219,196,177,444,72,4,529,139
358,Serie_A,2017,14,Chievo,38,10,10,18,36,59,40,34,41,3,1,75,72,236,243,80,109,234,233,147,386,75,4,479,135
359,Serie_A,2017,15,Bologna,38,11,6,21,40,52,39,50,52,1,5,80,71,241,239,81,84,257,227,151,353,102,6,480,123
360,Serie_A,2017,16,Cagliari,38,11,6,21,33,61,39,50,46,3,3,107,72,317,290,85,87,250,237,179,371,96,6,607,120
361,Serie_A,2017,17,SPAL 2013,38,8,14,16,39,59,38,54,48,2,2,95,80,227,249,88,112,334,329,175,368,102,4,476,115
362,Serie_A,2017,18,Crotone,38,9,8,21,40,66,35,28,38,1,1,73,62,261,243,92,112,239,249,135,379,66,2,504,135
363,Serie_A,2017,19,Verona,38,7,4,27,30,78,25,51,45,1,5,80,63,265,254,106,157,235,204,143,357,96,6,519,101
364,Serie_A,2017,20,Benevento,38,6,3,29,33,84,21,38,40,2,5,95,70,247,243,101,112,246,253,165,466,78,7,490,146
365,Serie_A,2018,1,Juventus,38,28,6,4,70,30,90,30,46,2,2,140,104,235,220,65,73,238,249,244,443,76,4,455,227
366,Serie_A,2018,2,Napoli,38,24,7,7,74,36,79,32,43,1,4,143,112,191,209,79,84,199,233,255,550,75,5,400,290
367,Serie_A,2018,3,Atalanta,38,20,9,9,77,46,69,28,33,0,3,139,103,213,216,56,107,266,241,242,475,61,3,429,254
368,Serie_A,2018,4,Inter,38,20,9,9,57,33,69,33,42,1,2,168,134,228,229,73,83,238,263,302,459,75,3,457,238
369,Serie_A,2018,5,AC Milan,38,19,11,8,55,36,68,36,47,3,2,132,98,225,219,77,98,221,263,230,423,83,5,444,231
370,Serie_A,2018,6,Roma,38,18,12,8,66,48,66,40,50,1,1,123,104,227,226,98,91,219,193,227,459,90,2,453,257
371,Serie_A,2018,7,Torino,38,16,15,7,52,37,63,38,52,2,2,111,72,273,329,93,90,310,288,183,388,90,4,602,202
372,Serie_A,2018,8,Lazio,38,17,8,13,56,46,59,38,52,3,1,125,101,234,261,82,94,207,200,226,440,90,4,495,230
373,Serie_A,2018,9,Sampdoria,38,15,8,15,60,51,53,43,49,1,2,83,85,235,241,68,106,286,234,168,363,92,3,476,205
374,Serie_A,2018,10,Bologna,38,11,11,16,48,56,44,35,57,2,4,108,99,231,275,92,111,284,248,207,378,92,6,506,199
375,Serie_A,2018,11,Sassuolo,38,9,16,13,53,60,43,41,46,2,6,112,73,260,250,102,98,262,277,185,376,87,8,510,184
376,Serie_A,2018,12,Udinese,38,11,10,17,39,53,43,51,41,3,1,84,80,243,249,99,107,258,224,164,349,92,4,492,159
377,Serie_A,2018,13,SPAL 2013,38,11,9,18,44,56,42,56,57,2,1,101,95,262,222,95,118,305,272,196,334,113,3,484,161
378,Serie_A,2018,14,Fiorentina,38,8,17,13,47,45,41,45,46,2,3,118,118,254,288,73,95,251,273,236,415,91,5,542,216
379,Serie_A,2018,15,Cagliari,38,10,11,17,36,54,41,46,49,4,5,90,100,285,284,92,142,231,247,190,334,95,9,569,148
380,Serie_A,2018,17,Genoa,38,8,14,16,39,57,38,47,49,4,3,103,83,260,285,95,126,269,235,186,370,96,7,545,177
381,Serie_A,2018,18,Empoli,38,10,8,20,51,70,38,37,37,0,3,96,92,231,213,128,138,224,230,188,330,74,3,444,189
382,Serie_A,2018,19,Frosinone,38,5,10,23,29,69,25,45,57,0,2,88,72,285,268,125,122,276,261,160,322,102,2,553,143
383,Serie_A,2018,20,Chievo,38,2,14,22,25,75,20,53,56,4,3,73,58,262,312,104,148,262,233,131,281,109,7,574,136
384,Ligue_1,2014,1,Paris Saint Germain,38,24,11,3,83,36,83,27,36,1,2,103,68,209,231,51,63,271,291,171,480,63,3,440,221
385,Ligue_1,2014,2,Lyon,38,22,9,7,72,33,75,34,30,1,0,100,73,288,293,65,69,286,286,173,523,64,1,581,219
386,Ligue_1,2014,3,Monaco,38,20,11,7,51,26,71,27,31,3,2,115,97,249,257,47,62,319,235,212,451,58,5,506,165
387,Ligue_1,2014,4,Marseille,38,21,6,11,76,42,69,26,39,4,2,117,97,238,314,81,66,287,308,214,578,65,6,552,203
388,Ligue_1,2014,5,Saint-Etienne,38,19,12,7,51,30,69,33,33,0,2,115,92,256,301,44,84,259,240,207,445,66,2,557,152
389,Ligue_1,2014,6,Bordeaux,38,17,12,9,47,44,63,19,42,2,3,103,87,222,281,67,73,276,276,190,486,61,5,503,159
390,Ligue_1,2014,7,Lille,38,16,8,14,43,42,56,31,32,1,3,88,77,247,215,49,89,348,288,165,461,63,4,462,148
391,Ligue_1,2014,8,Montpellier,38,16,8,14,46,39,56,25,26,1,0,85,89,259,259,81,78,365,287,174,394,51,1,518,142
392,Ligue_1,2014,9,Rennes,38,13,11,14,35,42,50,29,26,0,1,83,65,209,273,66,68,203,233,148,360,55,1,482,125
393,Ligue_1,2014,10,Guingamp,38,15,4,19,41,55,49,23,35,4,3,80,69,235,241,78,94,295,281,149,354,58,7,476,135
394,Ligue_1,2014,11,Nice,38,13,9,16,44,53,48,38,46,2,4,123,70,253,293,64,86,300,271,193,414,84,6,546,139
395,Ligue_1,2014,12,SC Bastia,38,12,11,15,37,46,47,43,33,2,3,85,47,302,265,63,90,280,230,132,319,76,5,567,119
396,Ligue_1,2014,13,Caen,38,12,10,16,54,55,46,19,24,3,3,106,90,217,230,78,99,229,201,196,459,43,6,447,156
397,Ligue_1,2014,14,Nantes,38,11,12,15,29,40,45,32,38,2,1,92,77,268,299,57,84,217,197,169,419,70,3,567,135
398,Ligue_1,2014,15,Reims,38,12,8,18,47,66,44,34,42,1,3,101,79,263,281,97,93,275,246,180,436,76,4,544,137
399,Ligue_1,2014,16,Lorient,38,12,7,19,44,50,43,23,31,1,1,112,79,234,222,80,104,244,230,191,481,54,2,456,173
400,Ligue_1,2014,17,Toulouse,38,12,6,20,43,64,42,28,33,0,5,104,89,275,303,74,84,291,258,193,428,61,5,578,127
401,Ligue_1,2014,18,Evian Thonon Gaillard,38,11,4,23,41,62,37,30,36,1,3,82,70,261,272,84,85,257,215,152,328,66,4,533,102
402,Ligue_1,2014,19,Metz,38,7,9,22,31,61,30,34,37,0,3,90,64,270,325,78,81,223,209,154,447,71,3,595,149
403,Ligue_1,2014,20,Lens,38,7,8,23,32,61,29,37,33,4,1,88,68,258,294,62,114,224,231,156,407,70,5,552,126
404,Ligue_1,2015,1,Paris Saint Germain,38,30,6,2,102,19,96,20,25,0,1,119,85,190,205,62,55,203,242,204,564,45,1,395,250
405,Ligue_1,2015,2,Lyon,38,19,8,11,67,43,65,35,30,1,2,101,80,258,253,66,76,280,294,181,554,65,3,511,202
406,Ligue_1,2015,3,Monaco,38,17,14,7,57,50,65,41,43,2,2,104,101,264,281,72,96,291,245,205,427,84,4,545,169
407,Ligue_1,2015,4,Nice,38,18,9,11,58,41,63,24,42,3,3,83,86,223,228,71,81,271,246,169,387,66,6,451,161
408,Ligue_1,2015,5,Lille,38,15,15,8,39,27,60,35,48,3,3,119,79,262,313,59,74,327,294,198,475,83,6,575,154
409,Ligue_1,2015,6,Saint-Etienne,38,17,7,14,42,37,58,35,36,2,3,119,90,271,317,66,80,218,249,209,440,71,5,588,134
410,Ligue_1,2015,7,Caen,38,16,6,16,39,52,54,25,27,2,4,112,85,231,232,84,88,267,201,197,469,52,6,463,175
411,Ligue_1,2015,8,Rennes,38,13,13,12,52,54,52,37,30,2,1,106,71,227,236,82,92,236,210,177,418,67,3,463,154
412,Ligue_1,2015,9,Angers,38,13,11,14,40,38,50,30,40,3,3,73,61,241,280,48,80,268,214,134,397,70,6,521,131
413,Ligue_1,2015,10,Bordeaux,38,12,14,12,50,57,50,38,42,2,5,99,91,245,246,74,92,247,279,190,440,80,7,491,144
414,Ligue_1,2015,11,SC Bastia,38,14,8,16,36,42,50,38,44,4,6,86,45,270,260,55,90,268,244,131,332,82,10,530,110
415,Ligue_1,2015,12,Montpellier,38,14,7,17,49,47,49,30,34,1,1,93,93,225,251,69,77,258,279,186,393,64,2,476,144
416,Ligue_1,2015,13,Nantes,38,12,12,14,33,44,48,30,49,3,2,96,82,289,309,60,80,239,197,178,432,79,5,598,134
417,Ligue_1,2015,14,Marseille,38,10,18,10,48,42,48,31,40,5,4,131,93,240,271,62,81,277,282,224,475,71,9,511,181
418,Ligue_1,2015,15,Lorient,38,11,13,14,47,58,46,24,39,4,3,95,75,222,241,78,105,263,239,170,418,63,7,463,153
419,Ligue_1,2015,16,Guingamp,38,11,11,16,47,56,44,36,39,4,2,111,65,239,269,69,96,300,280,176,399,75,6,508,135
420,Ligue_1,2015,17,Toulouse,38,9,13,16,45,55,40,30,41,5,5,84,87,268,265,58,81,297,282,171,424,71,10,533,158
421,Ligue_1,2015,18,Reims,38,10,9,19,44,57,39,45,35,4,2,93,83,264,254,70,101,267,255,176,426,80,6,518,159
422,Ligue_1,2015,19,GFC Ajaccio,38,8,13,17,37,58,37,39,50,3,3,101,52,279,298,79,83,213,200,153,434,89,6,577,124
423,Ligue_1,2015,20,Troyes,38,3,9,26,28,83,18,37,34,7,2,130,76,217,217,120,114,236,193,206,448,71,9,434,154
424,Ligue_1,2016,1,Monaco,38,30,5,3,107,31,95,29,22,1,2,127,104,222,245,60,58,233,235,231,553,51,3,467,243
425,Ligue_1,2016,2,Paris Saint Germain,38,27,6,5,83,27,87,19,31,0,3,162,104,195,208,53,37,184,230,266,583,50,3,403,222
426,Ligue_1,2016,3,Nice,38,22,12,4,63,36,78,28,29,1,3,60,54,215,211,66,86,283,293,114,433,57,4,426,170
427,Ligue_1,2016,4,Lyon,38,21,4,13,80,48,67,25,36,1,4,140,109,243,258,74,62,257,276,249,570,61,5,501,207
428,Ligue_1,2016,5,Marseille,38,17,11,10,57,41,62,31,37,0,1,96,97,253,246,71,89,207,196,193,464,68,1,499,162
429,Ligue_1,2016,6,Bordeaux,38,15,14,9,53,43,59,29,35,2,3,88,73,228,214,84,77,267,250,161,451,64,5,442,155
430,Ligue_1,2016,7,Nantes,38,14,9,15,40,54,51,37,39,1,2,107,82,256,274,65,83,218,192,189,456,76,3,530,139
431,Ligue_1,2016,8,Rennes,38,12,14,12,36,42,50,29,27,1,3,76,82,225,237,68,70,242,226,158,436,56,4,462,147
432,Ligue_1,2016,9,Saint-Etienne,38,12,14,12,41,42,50,22,30,1,6,105,77,229,254,84,88,233,238,182,401,52,7,483,127
433,Ligue_1,2016,10,Guingamp,38,14,8,16,46,53,50,20,37,0,4,122,76,244,251,62,93,277,243,198,443,57,4,495,165
434,Ligue_1,2016,11,Lille,38,13,7,18,40,47,46,26,33,4,2,95,70,278,259,81,71,268,259,165,483,59,6,537,152
435,Ligue_1,2016,12,Angers,38,13,7,18,40,49,46,25,33,2,3,105,90,230,205,54,75,199,197,195,527,58,5,435,178
436,Ligue_1,2016,13,Toulouse,38,10,14,14,37,41,44,37,50,2,2,88,65,275,289,64,91,257,227,153,380,87,4,564,131
437,Ligue_1,2016,14,Metz,38,11,10,17,39,72,43,34,37,1,6,75,60,257,257,95,114,229,224,135,357,71,7,514,117
438,Ligue_1,2016,15,Montpellier,38,10,9,19,48,66,39,23,22,2,3,101,91,192,208,67,96,239,235,192,503,45,5,400,158
439,Ligue_1,2016,16,Caen,38,10,7,21,36,65,37,32,27,0,2,102,67,228,210,83,78,249,234,169,459,59,2,438,138
440,Ligue_1,2016,17,Dijon,38,8,13,17,46,58,37,29,39,0,6,96,76,226,268,90,107,249,232,172,426,68,6,494,156
441,Ligue_1,2016,18,Lorient,38,10,6,22,44,70,36,37,30,3,2,90,99,228,217,88,106,211,191,189,428,67,5,445,146
442,Ligue_1,2016,19,Nancy,38,9,8,21,29,52,35,37,39,0,5,94,71,241,256,84,88,242,244,165,373,76,5,497,107
443,Ligue_1,2016,20,SC Bastia,38,8,10,20,29,57,34,32,37,5,9,84,80,211,246,57,119,269,254,164,383,69,14,457,118
444,Ligue_1,2017,1,Paris Saint Germain,38,29,6,3,108,29,93,26,41,2,4,123,132,214,211,58,63,257,251,255,628,67,6,425,255
445,Ligue_1,2017,2,Monaco,38,24,8,6,85,45,80,43,28,3,1,108,87,256,252,56,93,273,279,195,490,71,4,508,182
446,Ligue_1,2017,3,Lyon,38,23,9,6,87,43,78,28,43,1,1,109,73,224,249,71,82,264,291,182,576,71,2,473,233
447,Ligue_1,2017,4,Marseille,38,22,11,5,80,47,77,36,45,1,2,129,114,232,276,53,93,236,259,243,623,81,3,508,232
448,Ligue_1,2017,5,Rennes,38,16,10,12,50,44,58,32,34,2,3,128,90,250,236,66,89,288,270,218,474,66,5,486,153
449,Ligue_1,2017,6,Bordeaux,38,16,7,15,53,48,55,34,40,2,1,99,80,263,268,60,76,244,249,179,469,74,3,531,156
450,Ligue_1,2017,7,Saint-Etienne,38,15,10,13,47,50,55,33,39,4,4,108,74,234,276,84,100,266,244,182,421,72,8,510,155
451,Ligue_1,2017,8,Nice,38,15,9,14,53,52,54,34,51,2,2,114,89,223,220,75,82,255,295,203,483,85,4,443,183
452,Ligue_1,2017,9,Nantes,38,14,10,14,36,41,52,28,40,3,3,95,81,244,246,69,82,219,211,176,499,68,6,490,139
453,Ligue_1,2017,10,Montpellier,38,11,18,9,36,33,51,35,37,1,1,107,78,219,225,62,55,247,306,185,493,72,2,444,158
454,Ligue_1,2017,11,Dijon,38,13,9,16,55,73,48,34,36,3,2,84,69,230,260,88,118,258,231,153,445,70,5,490,162
455,Ligue_1,2017,12,Guingamp,38,12,11,15,48,59,47,32,35,1,1,116,74,265,233,73,101,288,251,190,450,67,2,498,164
456,Ligue_1,2017,13,Amiens,38,12,9,17,37,42,45,38,36,1,3,75,65,239,264,85,96,245,238,140,359,74,4,503,102
457,Ligue_1,2017,14,Angers,38,9,14,15,42,52,41,25,46,0,3,94,75,230,261,73,70,236,227,169,463,71,3,491,156
458,Ligue_1,2017,15,Lille,38,10,8,20,41,67,38,23,37,2,4,91,80,243,236,86,108,234,215,171,428,60,6,479,142
459,Ligue_1,2017,16,Caen,38,10,8,20,27,52,38,34,34,3,1,114,88,263,259,69,83,262,194,202,456,68,4,522,128
460,Ligue_1,2017,17,Strasbourg,38,9,11,18,44,67,38,39,32,2,2,98,85,282,238,72,105,250,212,183,451,71,4,520,136
461,Ligue_1,2017,18,Toulouse,38,9,10,19,38,54,37,45,48,2,1,98,80,292,295,77,86,273,242,178,434,93,3,587,147
462,Ligue_1,2017,19,Troyes,38,9,6,23,32,59,33,38,38,4,3,95,70,246,250,92,106,207,209,165,360,76,7,496,123
463,Ligue_1,2017,20,Metz,38,6,8,24,34,76,26,36,44,3,4,99,74,251,280,99,111,233,226,173,428,80,7,531,161
464,Ligue_1,2018,1,Paris Saint Germain,38,29,4,5,105,35,91,27,37,1,3,128,110,223,247,58,77,205,255,238,561,64,4,470,228
465,Ligue_1,2018,2,Lille,38,22,9,7,68,33,75,28,41,0,4,79,85,211,267,54,72,265,269,164,494,69,4,478,195
466,Ligue_1,2018,3,Lyon,38,21,9,8,70,47,72,18,39,1,2,129,98,210,232,63,90,237,257,227,670,57,3,442,252
467,Ligue_1,2018,4,Saint-Etienne,38,19,9,10,59,41,66,34,33,3,4,119,105,221,234,76,80,275,209,224,498,67,7,455,179
468,Ligue_1,2018,5,Marseille,38,18,7,13,60,52,61,44,39,5,3,115,110,243,254,56,85,253,227,225,525,83,8,497,169
469,Ligue_1,2018,6,Montpellier,38,15,14,9,53,42,59,31,30,0,4,91,80,268,269,64,83,270,245,171,507,61,4,537,171
470,Ligue_1,2018,7,Nice,38,15,11,12,30,35,56,36,37,3,2,93,79,195,229,71,86,285,265,172,442,73,5,424,131
471,Ligue_1,2018,8,Reims,38,13,16,9,39,42,55,33,34,1,1,99,65,254,276,58,94,241,251,164,405,67,2,530,137
472,Ligue_1,2018,9,Nimes,38,15,8,15,57,58,53,34,36,4,1,111,91,248,239,74,108,267,253,202,517,70,5,487,180
473,Ligue_1,2018,10,Rennes,38,13,13,12,55,52,52,35,35,1,2,116,75,225,262,70,92,259,245,191,471,70,3,487,162
474,Ligue_1,2018,11,Strasbourg,38,11,16,11,58,48,49,29,40,2,2,83,75,252,260,73,82,235,195,158,404,69,4,512,157
475,Ligue_1,2018,12,Nantes,38,13,9,16,48,48,48,32,40,1,4,112,70,231,261,53,79,248,270,182,518,72,5,492,150
476,Ligue_1,2018,13,Angers,38,10,16,12,44,49,46,22,27,2,2,89,77,246,200,71,98,237,232,166,451,49,4,446,154
477,Ligue_1,2018,14,Bordeaux,38,10,11,17,34,42,41,32,42,3,2,94,74,239,298,67,87,254,265,168,424,74,5,537,135
478,Ligue_1,2018,15,Toulouse,38,8,14,16,35,57,38,34,44,1,4,86,73,260,300,75,104,263,236,159,432,78,5,560,132
479,Ligue_1,2018,16,Amiens,38,9,11,18,31,52,38,20,42,4,2,85,51,262,256,79,88,300,240,136,388,62,6,518,118
480,Ligue_1,2018,17,Monaco,38,8,12,18,38,57,36,43,49,2,5,110,85,262,264,66,81,274,259,195,467,92,7,526,159
481,Ligue_1,2018,18,Dijon,38,9,7,22,31,60,34,37,42,4,3,97,71,283,288,92,88,230,236,168,447,79,7,571,144
482,Ligue_1,2018,19,Caen,38,7,12,19,29,54,33,35,47,3,3,71,56,288,273,90,106,282,241,127,338,82,6,561,97
483,Ligue_1,2018,20,Guingamp,38,5,12,21,28,68,27,25,33,3,2,110,84,256,229,71,105,258,227,194,416,58,5,485,116
